6 13 31
###############################
#p * *3 f*b*  b4 ** f *sb 4  *#
# # # # #*# # #*# # # # # #*# #
#  *s* s **b **  5  f*  s *f  #
# #*# # # # #4# #b#1# # # # #*#
#   3** 2   fb*  *b   2  *  *s#
# # #*# # # # # #*#*#*#*# # # #
# b *   4   sf   * *x* *   4  #
# # # # #*# # # # # # #*# #*# #
#   **b*    *b   *2     4*    #
# # # # # # # # # #*# # # # #s#
#  **4*  f    2      s*  5    #
###############################