2 13 31
wwwwwwwwwwwwwwwwwwwwwwwwwwwwwww
wp * *2       *  *b * f      *w
w # # # #*# # #*# # # # # #*# w
w    b * *s* *f      *    **  w
w #*# # # # #1# #b#1# # # # #*w
w          *     **      *  **w
w # #*# # # # # #*#*#*#*# # # w
w   *        *   * *x* *      w
w # # # #*# # # # # # #*# #*# w
w   *bs*         *1           w
w # # # # # # # # #*# # # # #*w
w  *s *   *    2              w
wwwwwwwwwwwwwwwwwwwwwwwwwwwwwww