3 13 31
wwwwwwwwwwwwwwwwwwwwwwwwwwwwwww
wp   *b s*    *   2           w
w # # #*# # # # # # # # # # # w
w*     *f * b  *   * s* 3 *   w
w # # # # #*# # # # # # #*# # w
w*   *s*    *f* * x **        w
w # # # # # # # # # # # # #*# w
w    *     s        *    *b  3w
w #*# # #*#*#*#*# # #1# # #*# w
w        *   *2*    *   f     w
w*# # # # # # # # # # #*# # #*w
w *    b **    *s **f     1   w
wwwwwwwwwwwwwwwwwwwwwwwwwwwwwww