4 13 31
###############################
#p    * b*    s   3   4       #
# # # #*# # # # # # # # # # # #
#      ** f *  *   * b* 3 *   #
# # # # # #*# # # # # # #*# # #
#*   s *    *b* *   **        #
# # # # # # # # # # # # # #*# #
#    *     *        b    **  3#
# #*# # #*#s#*#*# # #1# # #f# #
#        * 4 *2*    *   *     #
#*# # # # # # # # # # #*# # #*#
#x*    * b*    *s **f     1   #
###############################