5 13 31
###############################
#p * *3       b  ** f *      *#
# # # # #*# # #*# # # # # #*# #
#    * s **b **  5   *    *f  #
# #*# # # # #4# #b#1# # # # #*#
#          *     *b      *  *s#
# # #*# # # # #x#*#*#*#*# # # #
#   *        f   * *x* *   4  #
# # # # #*# # # # # # #*# #*# #
#   **b*         *2           #
# # # # # # # # # #*# # # # #s#
#  ** *5  f    2              #
###############################