2 13 31
###############################
#p * *2       *  *b * f      *#
# # # # #*# # #*# # # # # #*# #
#    b * *s* *f      *    **  #
# #*# # # # #1# #b#1# # # # #*#
#          *     **      *  **#
# # #*# # # # # #*#*#*#*# # # #
#   *        *   * *x* *      #
# # # # #*# # # # # # #*# #*# #
#   *bs*         *1           #
# # # # # # # # # #*# # # # #*#
#  *s *   *    2              #
###############################