3 13 31
###############################
#p   *b s*    *   2           #
# # # #*# # # # # # # # # # # #
#*     *f * b  *   * s* 3 *   #
# # # # # #*# # # # # # #*# # #
#*   *s*    *f* * x **        #
# # # # # # # # # # # # # #*# #
#    *     s        *    *b  3#
# #*# # #*#*#*#*# # #1# # #*# #
#        *   *2*    *   f     #
#*# # # # # # # # # # #*# # #*#
# *    b **    *s **f     1   #
###############################