6 13 31
wwwwwwwwwwwwwwwwwwwwwwwwwwwwwww
wp * *3 f*b*  b4 ** f *sb 4  *w
w # # # #*# # #*# # # # # #*# w
w  *s* s **b **  5  f*  s *f  w
w #*# # # # #4# #b#1# # # # #*w
w   3** 2   fb*  *b   2  *  *sw
w # #*# # # # # #*#*#*#*# # # w
w b *   4   sf   * *x* *   4  w
w # # # #*# # # # # # #*# #*# w
w   **b*    *b   *2     4*    w
w # # # # # # # # #*# # # # #sw
w  **4*  f    2      s*  5    w
wwwwwwwwwwwwwwwwwwwwwwwwwwwwwww