5 13 31
wwwwwwwwwwwwwwwwwwwwwwwwwwwwwww
wp * *3       b  ** f *      *w
w # # # #*# # #*# # # # # #*# w
w    * s **b **  5   *    *f  w
w #*# # # # #4# #b#1# # # # #*w
w          *     *b      *  *sw
w # #*# # # # #x#*#*#*#*# # # w
w   *        f   * *x* *   4  w
w # # # #*# # # # # # #*# #*# w
w   **b*         *2           w
w # # # # # # # # #*# # # # #sw
w  ** *5  f    2              w
wwwwwwwwwwwwwwwwwwwwwwwwwwwwwww