4 13 31
wwwwwwwwwwwwwwwwwwwwwwwwwwwwwww
wp    * b*    s   3   4       w
w # # #*# # # # # # # # # # # w
w      ** f *  *   * b* 3 *   w
w # # # # #*# # # # # # #*# # w
w*   s *    *b* *   **        w
w # # # # # # # # # # # # #*# w
w    *     *        b    **  3w
w #*# # #*#s#*#*# # #1# # #f# w
w        * 4 *2*    *   *     w
w*# # # # # # # # # # #*# # #*w
wx*    * b*    *s **f     1   w
wwwwwwwwwwwwwwwwwwwwwwwwwwwwwww